#########################################
A #     #   #           #   # #   #     #
# ### ### ### ######### # # # # # # ### #
#       # # # #           # #   # #   # #
####### # # ### ######### ### # ### #####
#       # #     #   #         #     #   #
# ### ### # ### # # # # ### ### ### # # #
#   # # #     #   # # # # # #   # # # # #
##### # # ### ######### # ##### # ### ###
#     #     #     # #       # #         #
### ##### # ### # # # # # # # # ##### ###
# #   # # # # # #   # # # # # # #       #
# ### # ##### # ##### # # ### ##### #####
#         #       #   # # # #     #     #
### ##### # ############### ### # # #####
#       # #   #         # #   # # #     #
### # # ### ### # ### # # ### # # ### ###
# # # #   # #   # #   #   # #   # # #   #
# # ### # # ########### # # ##### # #####
#   # # #   #   # # #   # #         #   #
##### ##### # ### # # ### # # ### # # ###
#   #                 # # # # # # # #   #
### ### ### ##### # # # ##### # # ##### #
# #   #   # #   # # # # #       #       #
# # # ####### ####### # ### ##### # ### #
# # #       #   #       # #   #   #   # #
# # ### ### ### # # ### # # ##### ### ###
#   # # #         # #   # #   #     #   #
### # # ### # # ######### ##### ####### #
#   # #   # # # #   # #   # #   # # #   #
### # ####### # ### # # ### ### # # #####
# #   #       #   # #       #   #   #   #
# ### ##### # ##### # ####### ##### ### #
# # # #     #   #   #       #         # #
# # ### ### ####### # ### ### ##### ### #
#     # #     #   # # # # #   # #       B
##### ### ### ### # ### # ### # # # # # #
#   #   # # # #     #   #   # #   # # # #
# ### ### # # # # ##### ### # # # ##### #
#           #   #             # #     # #
#########################################