###B###
#   ###
# #####
#    A#
#######