##########
#     B# #
# ## ### #
# ##   # #
# #### # #
#       A#
##########